
NO ./textures/matrix.xpm
EA ./textures/wolfen_stein/red_brick.xpm




 SO ./textures/wolfen_stein/grey_stone.xpm

WE ./textures/wolfen_stein/purple_stone.xpm

F220,100,0
 C 225,  30,  0    

        1
             11    
        1111111111111111111111111111
        1000000000110000000000001  1
        1011000001110000000000001  
        100100000000000000000000111
 111111111011000001110000000000001
 100000000011000001110111111111111
 11110111111111011100000010001
 1111011111111101 101010010001
 11000000110101011100000010001 1
 10000000000000001100000010001
 10000000000000001101010010001
111000001110101011111011110N0111111111111
 11110111 1110101 101111010001
 11111111 1111111 111111111111
    1                            1