NO ./textures/wolfen_stein/red_brick.xpm
SO ./textures/left.xpm
WE ./textures/wolfen_stein/grey_stone.xpm
EA ./textures/matrix.xpm
C 100,50,50
F 0,100,0

111111111111111
100000000000001
100000001000001
100000000000001
1000000E0000001
100000000000001
111111111111111