NO ./textures/wolfen_stein/red_brick.xpm
SO ./textures/left.xpm
WE ./textures/wolfen_stein/grey_stone.xpm
EA ./textures/matrix.xpm

F-200,100,0
C 225,  30,  0

1111
1E01
1111